





NO ./textures/wall_1.xpm
SO ./textures/wall_2.xpm


WE     ./textures/wall_3.xpm

sdf
F    220,  100  , 42

1111111111111111111111111
1000000000110000000000001
1011000001110000000000001
1001000000000000000000001
111111111011000001110000011111111
    10000000001100000111011000001
    11110111111111011100000011111
11110111111111011101010010001
11000000110101011000000010001
10000000000000001100000010001
1000000000N000001101010010001
11000001110101011111011110001
11110111 1110101 101111010001
11111111 1111111 111111111111

C 225,30,042

EA ./textures/wall_4.xpm










