





NO ./textures/wall_1.xpm
SO ./textures/wall_2.xpm


WE     ./textures/wall_3.xpm

sdf
F2   220,  100  , 42

1111111111111111111111111
1000000000000000000000001
1000000000000000000000001
1000000000000000000000001
1000000000000000000000001
1000000000000000000000001
100000000000W000000000001
1000000000000000000000001
1000000000000000000000001
1111111111111111111111111
C 225,30,042

EA ./textures/wall_4.xpm










