
SO ./textures/wall_2.xpm
EA ./textures/wall_3.xpm

WE     ./textures/wall_4.xpm
NO ./textures/wall_1.xpm

C 127, 205, 250


F 42, 42 , 127

1111111111111111111111111
1000000000000000000000001
1000000000000000000000001
1000000000000000000000001
10000000000N0000000000001
1000000000000000000000001
1000000000000000000000001
1000000000000000000000001
1000000000000000000000001
1111111111111111111111111