NO ./textures/wall_1.xpm
SO ./textures/wall_2.xpm


WE     ./textures/wall_3.xpm


F    220,  100  , 12

C 42,42,200

EA ./textures/wall_4.xpm


1111111111111111111111111
1000000000110000000001111
11110000011100N0000000001
1001000000000000000000001
111111111011000001110000011111111111111111111111111111111111111111111111111111111111111111111111111111111111111111111111111111111111111111111111111111111111111111111111111111111111111111111111111111111111111111111111111111111111111111111111111111111111111111111111111111111111111111111111111111111111111111111111111111111111111111111111111111111111111111111111111111111111111111111111111111111111111111111111111111111111111111111111111111111111111111111111111111111
    10000000001100000111011000000000000000000000000000000000000000000000000000000000000000000000000000000000000000000000000000000000000000000000000000000000000000000000000000000000000000000000000000000000000000000000000000000000000000000000000000000000000000000000000000000000000000000000000000000000000000000000000000000000000000000000000000000000000000000000000000000000000000000000000000000000000000000000000000000000000000000000000000000000000000000000000000001
    11110111111111011100000011111111111111111111111111111111111111111111111111111111111111111111111111111111111111111111111111111111111111111111111111111111111111111111111111111111111111111111111111111111111111111111111111111111111111111111111111111111111111111111111111111111111111111111111111111111111111111111111111111111111111111111111111111111111111111111111111111111111111111111111111111111111111111111111111111111111111111111111111111111111111111111111111111
11110111111111011101010010001
11000000110101011000000010001
10000000000000000000000010001
10000000000000001111010010001
11000000110101011000000010001
10000000000000000000000010001
10000000000000001111010010001
11000000110101011000000010001
10000000000000000000000010001
10000000000000001111010010001
11000000110101011000000010001
10000000000000000000000010001
10000000000000001111010010001
11000000110101011000000010001
10000000000000000000000010001
10000000000000001111010010001
11000000110101011000000010001
10000000000000000000000010001
10000000000000001111010010001
11000000110101011000000010001
10000000000000001111010010001
11000000110101011000000010001
10000000000000000000000010001
10000000000000001111010010001
11000000110101011000000010001
10000000000000000000000010001
10000000000000001111010010001
11000000110101011000000010001
10000000000000000000000010001
10000000000000001111010010001
11000000110101011000000010001
10000000000000000000000010001
10000000000000001111010010001
1100000111010101    111110001
11110111 1110101    111000001
11111111 1111111    111111111